NO ./textures/resized/1.xpm
SO ./textures/resized/2.xpm
WE ./textures/resized/3.xpm
EA ./textures/resized/4.xpm


F 139,69,19
C 135,206,235

1111110111111111
1000000000000001
1000001110000001
1010001N10000001
11 1001110000001
1111111111111111
