NO       ./assets/wall/13.xpm
SO   ./assets/wall/13.xpm



WE ./assets/wall/13.xpm



EA ./assets/wall/13.xpm


F 139,69,19
C 135,206,235

        1111111111111111111111111111111111111111
        10000000001100X00X00X00011111111111111
        1011000001110000......0X00000000000001
        1001000000D000X0......0011111111111111
1111111110110000011100000X00X0001
10000000001100000111D111111111111
11110111111111011100000010001
11110111111111011101010010001
1XX00000110101011100000010001
1XX000000001010000.....010001
1XX000000000000011010100D0001
1XX00001110101011111011110N0111
11110111 1110101 101111010001
11111111 1111111 111111111111
