NO ./path_to_the_north_texture
SO ./path_to_the_south_texture
WE ./path_to_the_west_texture
EA ./path_to_the_east_texture

F 139,69,19
C 135,206,235

        1111111111111111111111111
        1000000000110000000000001
        10110X0001110000......001
        1001000000D00000......001
111111111011000001110000000000001
10000000001100000111D111111111111
11110111111111011100000010001
11110111111111011101010010001
11000000110101011100000010001
100000000001010000..000010001
10000000000000001101010000001
11000001110101011111011110N0111
11110111 1110101 101111010001
11111111 1111111 111111111111
