NO ./textures/no.xpm
SO ./textures/so.xpm
WE ./textures/we.xpm
EA ./textures/ea.xpm


F 139,69,19
C 135,206,235

1111111  1111111 
1000001111000001
1000000000001101
1000001111001101
10000N1  1001101
1111111  1111111