NO     ./textures/no.xpm 


SO ./textures/so.xpm
WE ./textures/we.xpm

F 139,69,19 

EA ./textures/ea.xpm
C 135,206,235

111111111111111111
1
1111111  1111111 
1000011000000001
1000000000001101
1000001111001101
10000N1  1001101
1111111111111111


N S W E 